-34
34
-28
21
000000000000000000000000000000000000000000000000000000000000000000000
000000000000000000000000000000000000000000000000000000000000000000000
010000000000000000000000000000000000000000000000000000000000000000000
010000000000000000000000000000000000000000000000000000000000000000000
010000000000000000000000000000000000000000000000000000000000000000000
010000000000000000000000000000000000000000000000000000000000000000000
010000000000000000000000000000000000000000000000000000000000000000000
010000000000000000000000000000000000000000000000000000000000000000010
010000000000000000000000000000000000000000000000000000000000000000010
010000000000000000000000000000000000000000000000000000000000000000010
010000000000000000000000000000000000000000000000000000000000000000010
010000000000000000000000000000000000000000000000000000000000000000010
010000000000000000000000000000000000000000000000000000000000000000010
011111111111111111111111111111111111111111111111111111111111111111110
010000000000000000000000000000000000000000000000000000000000000001000
010000000000000000000000000000000000000000000000000000000000000001000
010000000000000000000000000000000000000000000000000000000000000001000
010000000000000000000000000000000000000000000000000000000000000001000
010000000000000000000000000000000000000000000000000000000000000001000
010000000000000000000000000000000000000000000000000000000000000001000
010000000000000000000000000000000000000000000000000000000000000010000
010000000000000000000000000000000000000000000000000000000000000010000
010000000000000000000000000000000000000000000000000000000000000010000
010000000000000000000000000000000000000000000000000000000000000100000
010000000000000000000000000000000000000000000000000000000000000100000
011111111111111111111111111111111111111111111111111111111111111100000
010000000000000000000000000000000000000000000000000000000000000000000
010000000000000000000000000000000000000000000000000000000000000000000
010000000000000000000000000000000000000000000000000000000000000000000
010000000000000000000000000000000000000000000000000000000000000000000
010000000000000000000000000000000000000000000000000000000000000000000
010000000000000000000000000000000000000000000000000000000000000000000
010000000000000000000000000000000000000000000000000000000000000000010
010000000000000000000000000000000000000000000000000000000000000000010
010000000000000000000000000000000000000000000000000000000000000000010
010000000000000000000000000000000000000000000000000000000000000000010
010000000000000000000000000000000000000000000000000000000000000000010
111111111111111111111111111111111111111111111111111111111111111111100
010000000000000000000000000000000000000000000000000000000000000000100
010000000000000000000000000000000000000000000000000000000000000000100
010000000000000000000000000000000000000000000000000000000000000000100
010000000000000000000000000000000000000000000000000000000000000000100
010000000000000000000000000000000000000000000000000000000000000000100
010000000000000000000000000000000000000000000000000000000000000000100
010000000000000000000000000000000000000000000000000000000000000000100
010000000000000000000000000000000000000000000000000000000000000000100
010000000000000000000000000000000000000000000000000000000000000000100
010000000000000000000000000000000000000000000000000000000000000000100
010000000000000000000000000000000000000000000000000000000000000000100
111111111111111111111111111111111111111111111111111111111111111111000
